############
#...#......#
..#.#.####.#
###.#....#.#
#....#.#.#..
####.#.#.#.#
#..#.#.#.#.#
##.#.#.#.#.#
#..........#
######.###.#
#......#...#
############